13 13 13 1 5 1 13 13 13 13 13 13 13 7 1 13
13 13 13 2 5 1 2 1 2 2 4 1 15 6 3 13
13 13 13 4 6 2 3 2 1 4 1 2 3 5 2 13
13 13 13 2 5 4 2 15 3 2 1 1 2 8 1 13
14 14 14 14 8 14 14 14 14 14 14 14 14 5 14 14
8 5 6 5 7 5 5 6 5 5 7 5 6 5 8 5
3 2 2 4 3 1 1 2 3 1 2 1 2 1 2 1
2 1 2 3 2 1 1 2 1 2 2 1 3 2 4 2
1 1 10 9 9 10 9 9 1 10 1 1 9 10 9 9
10 9 10 11 10 12 10 9 9 10 10 9 11 10 9 9
9 10 11 9 9 10 9 11 10 12 9 10 9 9 10 12
12 10 9 10 9 9 11 9 10 9 9 10 12 11 10 9