13 13 13 13 13 13 13 13 13 13 13 13 13 13 13 13 13 13 13 13 13 13 13 13 13 13 13 13 13 13 13 13 13 13 13 13 13 13 13 13 13 13 13 13 13 13 13 13 13 13 
13 13 13 13 13 13 13 13 13 13 13 13 13 13 13 13 13 13 13 13 13 13 13 13 13 13 13 13 13 13 13 13 13 13 13 13 13 13 13 13 13 13 13 13 13 13 13 13 13 13 
13 13 13 13 13 13 13 13 13 13 13 13 13 13 13 13 13 13 13 13 1 10 10 10 10 10 1 13 13 13 13 13 13 13 13 13 13 13 13 13 13 13 13 13 13 13 13 13 13 13 
13 13 13 13 13 13 13 13 13 13 13 13 13 13 13 13 13 13 13 13 10 10 10 10 10 10 10 13 13 13 13 13 13 13 13 13 13 13 13 13 13 13 13 13 13 13 13 13 13 13 
13 13 13 13 13 13 13 13 13 13 13 13 13 13 13 13 13 13 13 13 10 10 10 10 10 10 10 13 13 13 13 13 13 13 13 13 13 13 13 13 13 13 13 13 13 13 13 13 13 13 
13 13 13 13 13 13 13 13 13 13 13 13 13 13 13 13 13 13 13 13 10 10 10 10 10 10 10 13 13 13 13 13 13 13 13 13 13 13 13 13 13 13 13 13 13 13 13 13 13 13 
13 13 13 13 13 13 13 13 13 13 13 13 13 13 13 13 13 13 13 13 13 10 10 10 10 10 13 13 13 13 13 13 13 13 13 13 13 13 13 13 13 13 13 13 13 13 13 13 13 13 
13 13 13 13 13 13 13 13 13 3 3 3 13 13 13 13 13 13 13 13 1 1 1 5 1 1 1 13 13 13 13 13 13 1 5 5 5 5 5 5 5 13 13 13 13 13 13 13 13 13 
13 13 13 13 13 13 13 13 13 3 3 3 13 13 13 13 13 13 13 13 13 1 1 1 1 1 13 13 13 13 13 13 13 13 5 5 5 5 5 5 5 5 13 13 13 13 13 13 13 13 
13 13 13 13 13 13 13 13 13 3 3 3 13 13 13 13 13 13 13 13 13 13 1 1 1 13 13 13 13 13 13 13 13 13 5 5 5 5 5 5 5 5 13 13 13 13 13 13 13 13 
13 13 13 13 13 13 13 13 13 3 3 3 13 13 13 13 13 13 13 13 13 13 13 5 13 13 13 13 13 13 13 13 13 13 5 5 5 5 5 5 5 5 13 13 13 13 13 13 13 13 
13 13 13 13 13 13 13 13 13 13 1 13 13 13 13 13 13 13 13 13 13 13 13 5 13 13 13 13 13 13 13 13 13 13 5 5 5 5 5 5 5 5 13 13 13 13 13 13 13 13 
13 13 13 13 13 13 13 13 13 13 1 13 13 13 13 13 13 13 13 13 13 13 13 5 13 13 13 13 13 13 13 13 13 13 13 5 5 5 5 5 5 13 13 13 13 13 13 13 13 13 
13 13 13 13 13 13 13 13 13 13 1 13 13 13 13 13 13 13 13 13 13 13 13 5 13 13 13 13 13 13 13 13 13 13 13 13 13 13 5 13 13 13 13 13 13 13 13 13 13 13 
13 13 13 13 13 13 13 13 13 13 1 13 13 13 13 13 13 13 13 13 13 13 13 5 13 13 13 13 13 13 13 13 13 13 13 13 13 13 5 13 13 13 13 13 13 13 13 13 13 13 
13 13 13 13 13 13 13 13 13 13 1 13 13 13 13 13 13 13 13 13 13 13 13 5 13 13 13 13 13 13 13 13 13 13 13 13 13 13 5 13 13 13 13 13 13 13 13 13 13 13 
13 13 13 13 13 13 13 13 1 1 1 13 13 13 13 13 13 13 13 13 13 13 13 5 13 13 13 13 13 13 13 13 13 13 13 13 13 13 5 13 13 13 13 13 13 13 13 13 13 13 
13 13 13 13 13 13 13 13 1 13 13 13 13 13 13 13 13 13 13 13 13 13 13 5 13 13 13 13 13 13 13 13 13 13 13 13 13 13 5 13 13 13 13 13 13 13 13 13 13 13 
13 13 13 13 13 13 13 13 1 13 13 13 13 13 13 13 13 13 13 13 13 13 1 5 1 13 13 13 13 13 13 13 13 13 13 13 5 5 5 13 13 13 13 13 13 13 13 13 13 13 
13 13 13 13 13 13 13 13 1 13 13 13 13 13 13 13 13 13 13 13 13 1 1 5 1 1 13 13 13 13 13 13 13 13 13 13 5 13 13 13 13 13 13 13 13 13 13 13 13 13 
13 13 13 13 13 13 13 13 1 13 13 13 13 13 13 13 13 13 13 13 1 1 1 5 1 1 1 13 13 13 13 13 13 13 13 5 5 13 13 13 13 13 13 13 13 13 13 13 13 13 
13 13 13 13 13 13 13 13 1 13 13 13 5 5 5 5 5 5 5 5 5 5 5 5 5 5 5 5 5 5 5 5 5 5 5 5 5 13 13 13 13 13 13 13 13 13 13 13 13 13 
13 13 13 13 13 13 13 13 1 13 13 13 1 13 13 13 13 13 13 13 1 1 1 5 1 1 1 13 13 13 13 13 13 13 13 13 5 13 13 13 13 13 13 13 13 13 13 13 13 13 
13 13 13 13 13 13 13 13 1 13 13 13 1 13 13 13 13 13 13 13 13 1 1 5 1 1 13 13 13 13 13 13 13 13 13 13 5 13 13 13 13 13 13 13 13 13 13 13 13 13 
13 13 13 13 13 13 13 13 1 13 13 13 1 13 13 13 13 13 13 13 13 13 1 5 1 13 13 13 13 13 13 13 13 13 13 13 5 13 13 13 13 13 13 13 13 13 13 13 13 13 
13 13 13 13 13 13 13 13 1 13 13 13 1 1 1 13 13 13 13 13 13 13 13 5 13 13 13 13 13 13 13 13 13 13 13 13 5 13 13 13 13 13 13 13 13 13 13 13 13 13 
13 13 13 13 13 13 13 13 1 13 13 13 13 13 1 13 13 13 13 13 13 13 13 5 13 13 13 13 13 13 13 13 13 13 13 13 5 13 13 13 13 13 13 13 13 13 13 13 13 13 
13 13 13 13 13 13 13 13 1 13 13 13 13 13 1 13 13 13 13 13 13 13 13 5 13 13 13 1 13 13 13 13 13 13 13 1 5 13 13 13 13 13 13 13 13 13 13 13 13 13 
13 13 13 13 13 13 13 13 1 13 13 13 13 13 1 13 13 13 13 13 13 13 13 5 13 13 13 13 13 13 1 13 13 13 13 13 5 13 13 13 13 13 13 13 13 13 13 13 13 13 
13 13 13 13 13 13 13 13 1 1 1 1 1 1 1 13 13 13 13 13 13 13 13 5 13 13 13 13 13 13 1 13 13 13 13 13 5 13 13 13 13 13 13 13 13 13 13 13 13 13 
13 13 13 13 13 13 13 13 1 1 1 1 1 1 1 13 13 13 13 13 13 13 13 5 13 13 13 13 13 13 13 13 13 13 13 13 1 13 13 13 13 13 13 13 13 13 13 13 13 13 
13 13 13 13 13 13 13 13 1 1 1 1 1 1 1 13 13 13 13 13 13 13 13 5 13 13 13 13 13 13 13 13 13 13 13 1 1 1 13 13 13 13 13 13 13 13 13 13 13 13 
13 13 13 13 13 13 13 13 1 1 1 1 1 1 1 13 13 13 13 13 13 13 13 5 13 13 13 13 13 13 13 13 13 13 13 1 1 1 13 13 13 13 13 13 13 13 13 13 13 13 
13 13 13 13 13 13 13 13 1 1 1 1 1 1 1 13 13 13 13 13 13 13 13 5 13 13 13 13 13 13 13 13 13 13 13 1 1 1 13 13 13 13 13 13 13 13 13 13 13 13 
13 13 13 13 13 13 13 13 1 1 1 1 1 1 1 13 13 13 13 13 13 13 13 5 13 13 13 13 13 13 13 13 13 13 13 1 1 1 13 13 13 13 13 13 13 13 13 13 13 13 
13 13 13 13 13 13 13 13 13 13 13 13 13 13 13 13 13 13 13 13 13 13 13 5 13 13 13 13 13 13 13 13 13 13 13 1 1 1 13 13 13 13 13 13 13 13 13 13 13 13 
13 13 13 13 13 13 13 13 13 13 13 13 13 13 13 13 13 13 13 1 1 1 1 1 1 1 1 13 13 13 13 13 13 13 1 1 1 1 1 13 13 13 13 13 13 13 13 13 13 13 
13 13 13 13 13 13 13 13 13 13 13 13 13 13 13 13 13 13 1 1 1 1 1 1 1 1 1 1 13 13 1 13 13 1 1 1 1 1 1 13 13 13 13 13 13 13 13 13 13 13 
13 13 13 13 13 13 13 13 13 13 13 13 13 13 13 13 13 13 1 1 1 1 1 1 1 1 1 1 13 13 13 13 1 1 1 1 1 1 1 13 13 13 13 13 13 13 13 13 13 13 
13 13 13 13 13 13 13 13 13 13 13 13 13 1 13 13 13 13 1 1 1 1 1 1 1 1 1 1 1 13 13 13 1 1 1 1 1 13 1 13 13 13 13 13 13 13 13 13 13 13 
13 13 13 13 13 13 13 13 13 13 13 13 13 13 13 13 13 13 1 1 1 1 1 1 1 1 1 1 1 1 1 1 1 1 13 1 1 1 1 13 13 13 13 13 13 13 13 13 13 13 
13 13 13 13 13 13 13 13 13 13 13 13 13 1 13 13 13 13 13 1 1 1 1 1 1 1 1 13 13 13 13 1 1 1 1 1 1 1 1 13 13 13 13 13 13 13 13 13 13 13 
13 13 13 13 13 13 13 13 13 13 13 13 13 13 13 13 13 13 13 13 1 1 1 1 1 1 13 13 13 13 13 1 1 13 1 1 13 1 1 13 13 13 13 13 13 13 13 13 13 13 
13 13 13 13 13 13 13 13 13 13 13 13 13 13 13 13 13 13 13 13 13 13 13 13 13 13 13 13 13 13 13 13 1 1 1 1 1 1 13 13 13 13 13 13 13 13 13 13 13 13 
13 13 13 13 13 13 13 13 13 13 13 13 13 13 13 13 13 13 13 13 13 13 13 13 13 13 13 13 13 13 13 13 13 13 13 13 13 13 13 13 13 13 13 13 13 13 13 13 13 13 
13 13 13 13 13 13 13 13 13 13 13 13 13 13 13 13 13 13 13 13 13 13 13 13 13 13 13 13 13 13 13 13 13 13 13 13 13 13 13 13 13 13 13 13 13 13 13 13 13 13 
13 13 13 13 13 13 13 13 13 13 13 13 13 13 13 13 13 13 13 13 13 13 13 13 13 13 13 13 13 13 13 13 13 13 13 13 13 13 13 13 13 13 13 13 13 13 13 13 13 13 
13 13 13 13 13 13 13 13 13 13 13 13 13 13 13 13 13 13 13 13 13 13 13 13 13 13 13 13 13 13 13 13 13 13 13 13 13 13 13 13 13 13 13 13 13 13 13 13 13 13 
13 13 13 13 13 13 13 13 13 13 13 13 13 13 13 13 13 13 13 13 13 13 13 13 13 13 13 13 13 13 13 13 13 13 13 13 13 13 13 13 13 13 13 13 13 13 13 13 13 13 
13 13 13 13 13 13 13 13 13 13 13 13 13 13 13 13 13 13 13 13 13 13 13 13 13 13 13 13 13 13 13 13 13 13 13 13 13 13 13 13 13 13 13 13 13 13 13 13 13 13 